NO textures/book_shell.xpm
SO textures/book_shell.xpm
WE textures/book_shell.xpm
EA textures/book_shell.xpm

F 255,30,0
C 200,100,0
C 200,100,0

11111
1N001
11111
