NO ../textures/book_shell.xpm
SO ../textures/book_shell.xpm
WE ../texture/book_shell.xpm
EA ../texture/book_shell.xpm

F 255 30 0


11111
1N001
11111
