NO ../textures/book_shell.xpm
SO ../textures/book_shell.xpm
WE ../texture/book_shell.xpm
EA ../texture/book_shell.xpm

C 255,30,0
F 255,30,13123901`87486487832792399

11111
1N001
11111

