NO textures/book_shell.xpm
SO textures/book_shell.xpm
WE textures/book_shell.xpm
EA textures/book_shell.xpm

C 251,30
F 255,30,0

11111
1N001
11111

