NO ../textures/book_shell.xpm
SO ../textures/book_shell.xpm
WE ../texture/book_shell.xpm
EA ../texture/book_shell.xpm

C 200,100,0
C 200,100,0

11111
1A001
11111
