NO textures/book_shell.xpm
SO textures/book_shell.xpm
WE textures/book_shell.xpm
EA textures/book_shell.xpm

C 200,100,0
F 200,100,0

1111
1000011
1N01
100011
11111
