NO textures/book_shell.xpm
SO textures/book_shell.xpm
WE textures/book_shell.xpm
EA textures/book_shell.xpm

C 200,100,0
F 200,100,0

11111
1N001
11101
1100111
1000001
1110111
