NO ../textures/book_shell.xpm
SO ../textures/book_shell.xpm
WE ../texture/book_shell.xpm
EA ../texture/book_shell.xpm

11111
1N001
11111

C 200 100 0
C 200 100 0
