F 255,30,0
C 200,100,0

NO textures/book_shell.xpm
SO textures/book_shell.xpm
EA textures/book_shell.xpm
WE

11111
1N001
11111
