NO textures/book_shell.xpm
SO textures/book_shell.xpm
WE textures/book_shell.xpm
EA textures/book_shell.xpm

F 220,100,0
C 225,30,0

11111111
 1N000001
10000001
1000000011111
11111111
