NO textures/book_shell.xpm
SO textures/door.xpm
WE textures/witch.xpm
EA textures/book.xpm

F 255,30,0
C 200,100,0

111111111111
1S0000000001
100010000001
100000010001
100100000001
111111111111
