NO textures/book_shell.xpm
SO textures/door.xpm
WE textures/witch.xpm
EA textures/book.xpm

F 255,30,0
C 200,100,0

111111111111
100000000001
100010000001
100000010001
1N0100000001
111111111111
